###################################
# #             @  #     #      K #
# ### ########### ### # # ### ### #
#     #     #   #     # # #       #
####### ### ### ####### # # ##### #
#   #     #     #       #     #   #
# ### ### ####### ############# # #
# #   # #         #     #       # #
# # ### ############# # # ####### #
# # #       #     #   #   # #     #
# # # ##### # ### # ####### # #####
#   # #   #   #   #   #   #   #   #
# ### # ####### ### # # # # ### # #
#     #           S #   #       # #
###################################