####################################
#@    #   #    #     #             #
##### ## ## #  # # # # ########### #
# #         ## # # # #           # #
# # ### ###### # # ##### ##### # # #
#   #     ##   # # #     #   # #   #
# ### ###### ### # # ##### # ### # #
# #   #  #   #   #   #     #     # #
# ### ## # ### ####### ########### #
#   #    #         #   #         # #
######## ####### ### ### ####### # #
#    #   #     # #   #   # #     # #
# ######## ### ### ### ### # ##### #
#       K  #       #       #      S#
####################################