####################################
#                                  #
#      F     F        F            #
#                                  #
#                                  #
#        #####################     #
#                                  #
#                                  #
#                                  #
#            K                     #
#     #############                #
#                                  #
#                                  #
#     E                            #
#     @                         S  #
####################################