###################################
#         #                       #
#         #                       #
#         #       E               #
#         #########     ###########
#                                 #
#                                 #
#    K                            #
###################################
#                                 #
#                                 #
#     E                           #
####################           ####
#                  #           #  #
#         @        #     S     #  #
###################################