####################################
#                                  #
#                                  #
#    @                K            #
#################     ##############
#                                  #
#                                  #
#                                  #
#                   E              #
########    #######################
#                                  #
#                                  #
#                                  #
#                                  #
#                        S         #
####################################