####################################
#         #                       #
#         #                       #
#         #       E               #
#         #########     ###########
#                                 #
#                                 #
#    K                            #
################################## #
#                                 #
#                                 #
#     E                           #
####################           ####
#                  #           #  #
#         @        #     S     #  #
####################################