 ####################################
 #                    K             #
 #                                  #
 #                                  #
 #                                  #
 #                                  #
 #                                  #
 #                                  #
 #                                  #
 #                                  #
 #                                  #
 #                                  #
 #                                  #
 #                                  #
 #     @                         S  #
 ####################################