 ###################################
 #        K           K            #
 #                                 #
 #                                 #
 #                                 #
 #                                 #
 #                                 #
 #                                 #
 #                                 #
 #             ========            #
 #                                 #
 #                                 #
 #                                 #
 #                                 #
 #     @                         S #
 ###################################