#####################################################################################################################################################################################
#                                                                                                                                                                                  S#
#                                                                                                                                                                                   #
#                                                                                                                                                                                   #
#                                                                                                                                                                                   #
#                                                                                                                                                                                   #
#                                                                                                                                                                                   #
#                                                                                                                                                                                   #
#                                                                                                                                                                                   #
#                                                                                                                                                                                   #
#                                                                                                                                                                                   #
#                                                                                                                                                                                   #
#                                                                                    K                                                                                              #
#                                                                                   ###                                                                                             #
#                                                                                                                                                                                   #
#                                                                                                                                                                                   #
#                                                                                                                                                                                   #
#                                                                                                                                                                                   #
#                                                                                                                                                                                   #
#                                                                                                                                                                                   #
#                                                                                                                                                                                   #
#                                                                                                                                                                                   #
#@                                                                                                                                                                                  #
#####################################################################################################################################################################################